11;9
Id;position.X;position.Y;size.X;size.Y;Direction;Distance;vitesse;texture
1;62;61;3;1;2;4;7;1
1;67;58;4;1;2;4;3;1
1;45;46;4;1;-1;20;3;1
1;83;62;4;1;-1;7;5;1
1;88;62;4;1;1;7;3;1
1;100;55;4;1;2;7;5;1
1;114;40;4;1;2;12;5;1
1;107;45;4;1;-2;12;5;1
2;115;30;0;0;0;0;0;0
2;90;52;0;0;0;0;0;0
3;0;0;2;2;0;0;0;0