38;67
0;0;0;0;0;0;0;0;0;0;0;0;0;0;0;0;0;0;0;0;0;0;0;0;0;0;0;0;0;0;0;0;0;0;0;0;0;0;0;0;0;0;0;0;0;0;0;0;0;0;0;0;0;0;0;0;0;0;0;0;0;0;0;0;0;0;0
0;0;0;0;0;0;0;0;0;0;0;0;0;0;0;0;0;0;0;0;0;0;0;0;0;0;0;0;0;0;0;0;0;0;0;0;0;0;0;0;0;0;0;0;0;0;0;0;0;0;0;0;0;0;0;0;0;0;0;0;0;0;0;0;0;0;0
0;0;0;0;0;0;0;0;0;0;0;0;0;0;0;0;0;0;0;0;0;0;0;0;0;0;0;0;0;0;0;0;0;0;0;0;0;0;0;0;0;0;0;0;0;0;0;0;0;0;0;0;0;0;0;0;0;0;0;0;0;0;0;0;0;0;0
1;0;0;0;0;0;0;0;0;0;0;0;0;0;0;0;0;0;0;0;0;0;0;0;0;0;0;0;0;0;0;0;0;0;0;0;0;0;0;0;0;0;0;0;0;0;0;0;0;0;0;0;0;0;0;0;0;0;0;0;0;0;0;0;0;0;0
1;0;0;0;0;0;0;0;0;0;0;0;0;0;0;0;0;0;0;0;0;0;0;0;0;0;0;0;0;0;0;0;0;0;0;0;0;0;0;0;0;0;0;0;0;0;0;0;0;0;0;0;0;0;0;0;0;0;0;0;0;0;0;0;0;0;0
1;0;0;0;0;0;0;0;0;0;0;0;0;0;0;0;0;0;0;1;0;0;0;0;0;0;0;0;0;0;0;0;0;0;0;0;0;0;0;0;0;0;0;0;0;0;0;0;0;0;0;0;0;0;0;0;0;0;0;0;0;0;0;0;0;0;0
1;2;2;2;2;2;2;2;2;2;2;2;2;2;2;2;2;2;2;2;2;2;2;2;-2;-2;-2;-2;-2;-2;0;0;0;0;0;0;0;0;0;0;0;0;0;0;0;0;0;0;0;0;0;0;0;0;0;0;0;0;0;0;0;0;0;0;0;0;0
1;1;1;1;1;1;1;1;1;1;1;1;1;1;1;1;1;1;1;1;1;1;1;1;-1;-1;-1;-1;-1;-1;2;0;0;0;0;0;0;0;0;0;0;0;0;0;0;0;0;0;0;0;0;0;0;0;0;0;0;0;0;0;0;0;0;0;0;0;0
1;1;1;1;1;1;1;1;1;1;1;1;1;1;1;1;1;1;1;1;1;1;1;1;-1;-1;-1;-1;-1;-1;1;2;0;0;0;0;0;0;0;0;0;0;0;0;0;0;0;0;0;0;0;0;0;0;0;0;0;0;0;0;0;0;0;0;0;0;0
1;1;1;1;1;1;1;1;1;1;1;1;1;1;1;1;1;1;1;1;1;1;1;1;-1;-1;-1;-1;-1;-1;1;1;1;1;1;1;1;1;1;1;1;1;1;1;1;1;1;1;1;1;1;1;1;1;1;1;1;1;1;1;1;1;1;1;0;0;0
1;1;1;1;1;1;1;1;1;1;1;1;1;1;1;1;1;1;1;1;1;1;1;1;-1;-1;-1;-1;-1;-1;1;1;1;1;1;1;1;1;1;1;1;1;1;1;1;1;1;1;1;1;1;1;1;1;1;1;1;1;1;1;1;1;1;1;0;0;0
1;1;1;1;1;1;1;1;1;1;1;1;1;1;1;1;1;1;1;1;1;1;1;1;-9;-9;-9;-8;-9;-9;1;1;1;1;1;1;1;1;1;1;1;1;1;1;1;1;1;1;1;1;-9;-9;-9;-9;-9;-9;-9;-9;-9;-9;-9;-9;-9;-9;-9;-9;-9
1;1;1;1;1;1;1;1;1;1;1;1;1;1;1;1;1;1;1;1;1;1;1;1;-9;-9;-9;-9;-9;-9;1;1;1;1;1;1;1;1;1;1;1;1;1;1;1;1;1;1;1;1;-9;-9;-9;-9;-9;-9;-9;-9;-9;-9;-9;-9;-9;-9;-9;-9;-9
1;1;1;1;1;1;1;1;1;1;1;1;1;1;1;1;1;1;1;1;1;1;1;1;-9;-9;-9;-9;-9;-9;1;1;1;1;1;1;1;1;1;1;1;1;1;1;1;1;1;1;1;1;-9;-9;-9;-9;-9;-9;-9;-9;-9;-9;-9;-9;-9;-9;-9;-9;-9
1;1;1;1;1;1;1;1;1;1;1;1;1;1;1;1;1;1;1;1;1;1;1;1;-9;-9;-9;-9;-9;-9;1;1;1;1;1;1;1;1;1;1;1;1;1;1;1;1;1;1;1;1;-9;-9;-9;-9;-9;-9;-8;-9;-9;-9;-9;-9;-8;-9;-9;-9;-9
1;1;1;1;1;1;1;1;1;1;1;1;1;1;1;1;1;1;1;1;1;1;1;1;-9;-9;-8;-9;-9;-9;1;1;1;1;1;1;1;1;1;1;1;1;1;1;1;1;1;1;1;1;-9;-9;-9;-9;-9;-9;-9;-9;-9;-9;-9;-9;-9;-9;-9;-9;1
1;1;1;1;1;1;1;1;1;1;1;1;1;1;1;1;1;1;1;1;1;1;1;1;-9;-9;-9;-9;-9;-9;1;1;1;1;1;1;1;1;1;1;1;1;1;1;1;1;1;1;1;1;-9;-9;-9;-9;-9;-9;2;2;2;2;-9;-9;-9;-9;-9;1;1
1;1;1;1;1;1;1;1;1;1;1;1;1;1;1;1;1;1;1;1;1;1;1;1;-9;-9;-9;-9;-9;-9;1;1;1;1;1;1;1;1;1;1;1;1;1;1;1;1;1;1;1;1;-9;-9;-9;-8;-9;-9;-9;2;2;1;1;1;1;1;1;1;1
1;1;1;1;1;1;1;1;1;1;1;1;1;1;1;1;1;1;1;1;1;1;1;1;-9;-9;-9;-9;-9;-9;1;1;1;1;1;1;1;1;1;1;1;1;1;1;1;1;1;1;1;1;-9;-9;-9;-9;-9;-9;-9;-9;-9;1;1;1;1;1;1;1;1
1;1;1;1;1;1;1;1;1;1;1;1;1;1;1;1;1;1;1;1;1;1;1;1;-9;-9;-9;-9;-9;-9;1;1;1;1;1;1;1;1;1;1;1;1;1;1;1;1;1;1;1;1;-9;-9;-9;-9;-9;-9;-9;-9;-9;1;1;1;1;1;1;1;1
1;1;1;-9;-9;-9;-9;-9;-9;-9;-9;-9;4;4;4;4;4;4;4;4;4;-9;-9;-9;-9;-9;-9;-9;-9;-9;1;1;1;1;1;1;1;1;1;1;1;1;1;1;1;1;1;1;1;1;-9;-9;-9;-9;-9;-9;-9;-9;-9;1;1;1;1;1;1;1;1
1;1;1;-9;-9;-9;-9;-9;-9;-9;-9;-9;-9;-9;-9;-9;-9;-9;-9;-9;-9;-9;-9;-9;-9;-9;-9;-9;-9;-9;1;1;1;1;1;1;1;1;1;1;1;1;1;1;1;1;1;1;1;1;-9;-9;-9;-9;-9;-8;-9;-9;-9;1;1;1;1;1;1;1;1
1;1;1;-9;-9;-9;-8;-9;-9;-9;-9;-8;-9;-9;-9;-9;-9;-8;-9;-9;-9;-9;-8;-9;-9;-9;-9;-8;-9;-9;1;1;1;1;1;1;1;1;1;1;1;1;1;1;1;1;1;1;1;1;-9;-9;-9;-9;-9;-9;-9;-9;-9;1;1;1;1;1;1;1;1
1;1;1;-9;-9;-9;-9;-9;-9;-9;-9;-9;-9;-9;-9;-9;-9;-9;-9;-9;-9;-9;-9;-9;-9;-9;-9;-9;-9;-9;1;1;1;1;1;1;1;1;1;1;1;1;1;1;1;1;1;1;1;1;-9;-9;-9;-9;-9;-9;-9;-9;-9;1;1;1;1;1;1;1;1
1;1;1;-9;-9;-9;-9;1;1;1;3;3;3;3;3;3;3;3;3;3;3;3;3;3;1;1;1;1;1;1;1;1;1;1;1;1;1;1;1;1;1;1;1;1;1;1;1;1;1;1;-9;-9;-9;-9;-9;-9;-9;-9;-9;1;1;1;1;1;1;1;1
1;1;1;-9;-8;-9;-9;1;1;1;1;1;1;1;1;1;1;1;1;1;1;1;1;1;1;1;1;1;1;1;-9;-9;-9;-9;-9;-9;-9;-9;-9;-9;-9;-9;-9;-9;-9;-9;-9;-9;-9;-9;-9;-9;-9;-9;-9;-8;-9;-9;-9;1;1;1;1;1;1;1;1
1;1;1;-9;-9;-9;-9;1;1;1;1;1;1;1;1;1;1;1;1;1;1;1;1;1;1;1;1;1;1;-9;-9;-9;-9;-9;-9;-9;-9;-9;-9;-9;-9;-9;-9;-9;-9;-9;-9;-9;-9;-9;-9;-9;-9;-9;-9;-9;-9;-9;-9;1;1;1;1;1;1;1;1
1;1;1;-9;-9;-9;-9;1;1;1;1;1;1;1;1;1;1;1;1;1;1;1;1;1;1;1;-9;-9;-9;-9;-9;-9;-9;-9;-9;-9;-9;-9;-9;-9;-9;-9;-9;-9;-9;-9;-8;-9;-9;-9;-9;2;2;2;2;2;2;2;2;1;1;1;1;1;1;1;1
1;1;1;-9;-9;-8;-9;1;1;1;1;1;1;1;1;1;1;1;1;1;1;1;1;1;1;-9;-9;-9;-9;-9;-9;-9;-9;-9;-8;-9;-9;-9;-9;-9;-9;-9;-8;-9;-9;-9;-9;-9;-9;-9;-9;-9;-9;-9;-9;-9;-9;-9;-9;1;1;1;1;1;1;1;1
1;1;1;-9;-9;-9;-9;-9;-9;-9;-9;-9;-9;-9;-9;-9;-9;-9;-9;-9;-9;-9;-9;-9;-9;-9;-9;-9;-9;-9;-9;-9;-9;-9;-9;2;-9;-9;-9;-9;-9;-9;-9;-9;-9;-9;-9;-9;-9;-9;-9;-9;-9;-9;-9;-9;-9;-9;-9;1;1;1;1;1;1;1;1
1;1;1;-9;-9;-9;-9;-9;-9;-9;-9;-9;-9;-9;-9;-9;-9;-9;-9;-9;-9;-9;-9;-9;-9;-9;-9;-9;-9;-9;-9;-9;-9;-9;-9;2;-9;-9;-9;-9;-9;-9;-9;-9;-9;-9;-9;-9;-9;-9;-9;-9;-9;-9;-9;-9;-9;-9;-9;1;1;1;1;1;1;1;1
1;1;1;-9;-9;-9;-8;-9;-9;-9;-9;-9;-9;-8;-9;-9;-9;-9;-8;-9;-9;-9;-9;-8;-9;-9;-9;-9;-9;-9;-8;-9;-9;-9;-9;2;-9;-9;-9;-9;-9;-9;-9;-9;-9;-9;-9;-9;-9;-9;-9;-9;-9;-9;-9;-9;-9;-9;-9;1;1;1;1;1;1;1;1
1;1;1;-9;-9;-9;-9;-9;-9;-9;-9;-9;-9;-9;-9;-9;-9;-9;-9;-9;-9;-9;-9;-9;-9;-9;-9;-9;-9;-9;-9;-9;-9;-9;-9;2;2;-9;-9;-9;-9;-9;-9;-9;-9;-9;-9;-9;-9;-9;-9;-9;-9;-9;-9;-9;-9;-9;-9;1;1;1;1;1;1;1;1
1;1;1;1;1;1;1;1;1;3;3;2;3;3;2;2;3;3;2;3;3;3;1;1;1;1;1;1;1;1;1;1;1;1;1;1;2;2;3;3;3;2;3;3;3;2;3;3;3;2;3;3;3;3;3;3;3;3;3;1;1;1;1;1;1;1;1
1;1;1;1;1;1;1;1;1;1;1;1;1;1;1;1;1;1;1;1;1;1;1;1;1;1;1;1;1;1;1;1;1;1;1;1;1;1;1;1;1;1;1;1;1;1;1;1;1;1;1;1;1;1;1;1;1;1;1;1;1;1;1;1;1;1;1
1;1;1;1;1;1;1;1;1;1;1;1;1;1;1;1;1;1;1;1;1;1;1;1;1;1;1;1;1;1;1;1;1;1;1;1;1;1;1;1;1;1;1;1;1;1;1;1;1;1;1;1;1;1;1;1;1;1;1;1;1;1;1;1;1;1;1
1;1;1;1;1;1;1;1;1;1;1;1;1;1;1;1;1;1;1;1;1;1;1;1;1;1;1;1;1;1;1;1;1;1;1;1;1;1;1;1;1;1;1;1;1;1;1;1;1;1;1;1;1;1;1;1;1;1;1;1;1;1;1;1;1;1;1
1;1;1;1;1;1;1;1;1;1;1;1;1;1;1;1;1;1;1;1;1;1;1;1;1;1;1;1;1;1;1;1;1;1;1;1;1;1;1;1;1;1;1;1;1;1;1;1;1;1;1;1;1;1;1;1;1;1;1;1;1;1;1;1;1;1;1